NO ./path_to_texture.png
SO ./path_to_texture.png
WE ./path_to_texture.png
EA ./path_to_texture.png

F 220,100,0
C 225,30,0

       1111111111111111111111111
       10000000 0000000000011111
       1110000111110011100111111
       1100000000000000000000011
1111111100000000000000000N000011
11110000000000000101111100000001
11000000000000000000000000000011
11111111111111111111111111111111
